IWWWWWWWWIIIWWWWWWWWI
WEEEEEEEEWIWEEEEEEEEW
WEEEEEEEEWIWEEEEEEEEW
WEEEEEEEEWWWEEEEEEEEW
WEEEEEEEEEEEEEEEEEEEW
WEEEEEEEEEEEEEEEEEEEW
WEEEEEEEEEEEEEEEEEEEW
WEEEEEEEEEEEEEEEEEEEW
WEEEEEEEEEEEEEEEEEEEW
WEEEEEEEEEEEEEEEEEEEW
WEEEEEEEEEEEEEEEEEEEW
WEEEEEEEEEEEEEEEEEEEW
WEEEEEEEEEEEEEEEEEEEW
WEEEEEEEEEEEEEEEEEEEW
WEEEEEEEEEEEEEEEEEEEW
WEEEEEEEEEEEEEEEEEEEW
WEEEEEEEEEEEEEEEEEEEW
WEEEEEEEEWWWEEEEEEEEW
WEEEEEEEEWIWEEEEEEEEW
WEEEEEEEEWIWEEEEEEEEW
IWWWWWWWWIIIWWWWWWWWI