IWWWWWWWWIIIWWWWWWWWI
WEEEEEEEEWIWEEEEEEEEW
WEEEWWEEEWIWEEEWWEEEW
WEEEWWEEEWWWEEEWWEEEW
WEEEEEEEEEEEEEEEEEEEW
WEEEEEEEEEEEEEEEEEEEW
WEEEEEEEEEEEEEEEEEEEW
WEEEEEEEEEEEEEEEEEEEW
IWWWWWEEEEEEEEEWWWWWI
IIIIIWEEEEEEEEEWIIIII
IWWWWWEEEEEEEEEWWWWWI
WEEEEEEEEEEEEEEEEEEEW
WEEEEEEEEEEEEEEEEEEEW
WEEEEEEEEEEEEEEEEEEEW
WEEEEEEEEEEEEEEEEEEEW
WEEEEEEEEEEEEEEEEEEEW
WEEEEEEEEEEEEEEEEEEEW
WEEEWWEEEWWWEEEWWEEEW
WEEEWWEEEWIWEEEWWEEEW
WEEEEEEEEWIWEEEEEEEEW
IWWWWWWWWIIIWWWWWWWWI